The lock clicks, and the glass door painfully wretches open. This is the place. The abadoned arcade at the edge of Downtown. The musty tomb of the lost and damned technological behemoths and radical trends of 80s and 90s pop culture.  The scene of the crime, where the owner was brtually, and supposedly, murdered. At least, that's what the headlines bolded out in capital lettering that Friday morning. Little did you know you'd end up chasing a lead to disprove that claim, twenty years later. This could be it. The story of the decade. Suddenly, the pager at your side beeps restlessly. You've had it for almost two weeks now, and it's never gone off this frequently. The messages ping in a chaotic stream saying just one thing over and over... GETMEOUTOFHEREGETMEOUTOFHEREGETMEOUTOFHERE
Control Freak
An Interactive Fiction by Galen Nakama
Release 1 / Serial number 170216 / Inform 7 build 6M62 (I6/v6.33 lib 6/12N) SD

Darkness
It is pitch dark, and you can't see a thing.

>drop front door key
That is not a good idea at all.

* * *

>drop pager
That's not a good idea at all.

* * *

>e
Darkness
It is pitch dark, and you can't see a thing.

* * *

>s
Power Room

>drop all
What do you want to drop those things in?

* * *

>i
You are carrying:
  a pager
  an arcade front door key

* * *

>w
You can't go that way.

* * *

>e
You can't go that way.

>s
Power Room

>drop pager
Dropped.

* * *

>x front desk
You see nothing special about Front desk.

* * *

>x key
It has no further use.