The lock clicks, and the glass door painfully wretches open. This is the place. The abadoned arcade at the edge of Downtown. The musty tomb of the lost and damned technological behemoths and radical trends of 80s and 90s pop culture.  The scene of the crime, where the owner was brtually, and supposedly, murdered. At least, that's what the headlines bolded out in capital lettering that Friday morning. Little did you know you'd end up chasing a lead to disprove that claim, twenty years later. This could be it. The story of the decade. Suddenly, the pager at your side beeps restlessly. You've had it for almost two weeks now, and it's lead you right here. As you enter the arcade's entrace, it is pitch black. You can see nothing. Find your way.

Control Freak
An Interactive Fiction by Galen Nakama
Release 1 / Serial number 170301 / Inform 7 build 6M62 (I6/v6.33 lib 6/12N) SD

Darkness
It is pitch dark, and you can't see a thing.

I beg your pardon?

I beg your pardon?

* * *

>drop front door key
That is not a good idea at all.

>e
Darkness
It is pitch dark, and you can't see a thing.

>s
Power Room

>drop key
Dropped.

>drop pager
Dropped.

>take all
pager: Taken.
arcade front door key: Taken.

* * *

>drop pager
That's not a good idea at all.

* * *

>e
Darkness
It is pitch dark, and you can't see a thing.

>e
Darkness
It is pitch dark, and you can't see a thing.

>take cheat codes
You can't see any such thing.

>s
You can't go that way.

>w
Darkness
It is pitch dark, and you can't see a thing.

>e
Darkness
It is pitch dark, and you can't see a thing.

>w
Darkness
It is pitch dark, and you can't see a thing.

>s
Power Room
You can see a Steel Door here.

>pull lever
Good job!

>n
Office

>w
Lobby
You can see a Pizzeria Door and an arcade machine (closed) here.

>e
Office

>e
Storage Room

>take cheat codes
Taken.

>w
Office

>w
Lobby
You can see a Pizzeria Door and an arcade machine (closed) here.

>play with cheat codes
You win!

>take coins
You can't see any such thing.

>open arcade machine
It seems to be locked.

>unlock arcade machine
What do you want to unlock the arcade machine with?

>cheat codes
You unlock the arcade machine.

>take coins
You can't see any such thing.

* * *

>w
Darkness
It is pitch dark, and you can't see a thing.

>n
You can't go that way.

>s
Power Room
You can see a Steel Door here.

>open steel door
It seems to be locked.

>pull lever
It is fixed in place.

>s
(first opening the Steel Door)
It seems to be locked.

>n
Darkness
It is pitch dark, and you can't see a thing.

>activate lever
You can't see any such thing.

>s
Power Room
You can see a Steel Door here.

>activate lever
Good job!

>n
Darkness
It is pitch dark, and you can't see a thing.

>w
Lobby
You can see a Pizzeria Door here.

>e
Darkness
It is pitch dark, and you can't see a thing.

* * *

>activate lever
Good job!

>n
Office

* * *

>w
Lobby
You can see a Pizzeria Door and an arcade machine (closed) here.

>play arcade machine
You lose instantly.

>w
You can't go that way.

>e
Office

* * *

>e
Storage Room

>take cheat codew
I only understood you as far as wanting to take the cheat codes.

>take cheat codes
Taken.

>e
You can't go that way.

>w
Office

* * *

>w
Lobby
You can see a Pizzeria Door and an arcade machine (closed) here.

>play with cheat codes
You can't see any such thing.

* * *

>e
Darkness
It is pitch dark, and you can't see a thing.

>s
Darkness
It is pitch dark, and you can't see a thing.

>activate lever
Good job!

* * *

>n
Office

>e
You can't go that way.

>w
Darkness
It is pitch dark, and you can't see a thing.

* * *

>n
Office

>w
Lobby
You can see a Pizzeria Door here.

>play with cheatcodes
You can't see any such thing.

>play arcade machine with cheatcodes
You can't see any such thing.

>play machine with cheatcodes
You can't see any such thing.

>x arcade machine
You see nothing special about the arcade machine.

>play
What do you want to play?

>arcade machine
You lose instantly.

>i
You are carrying:
  a pager
  an arcade front door key

>w
You can't go that way.

>w
You can't go that way.

* * *

>e
Storage Room

>take cheatcodes
Taken.

>w
Office

>w
Lobby
You can see a Pizzeria Door here.

>play machine with cheacodes
You can't see any such thing.

* * *

>s
Darkness
It is pitch dark, and you can't see a thing.

>e
Darkness
It is pitch dark, and you can't see a thing.

>e
You can't go that way.

>n
Power Room
A red-lighted room with three walls of concrete and one intimidating steel door. Spooky. There's something on the wall here, a lever. Next to that lever is a metal sign.

You can see a Steel Door here.

>pull lever
At first, nothing happens. After another moment, the arcade shakes and the power surges on. Light is restored to the entire facility, at least enough to see. Time to explore, and get that story.

>w
Storage Room
It's super dusty, and shelves line the walls. There's cleaning supplies, buckets, a mop, and bunches of paper.

You can see a Closet here.

>s
Game Library
This place is full of shelves lined with game guides. The workers must've spent a lot of time in here during breaks, brushing up on their pop culture and videogame knowledge of easter eggs and secrets.

>w
Private Study
This is where the body was found. The scene of the crime. Now it is a clean office, with a clean desk and a clean bookcase.

>n
Office
Multiple people must've worked in here. No one person could have made this apocalyptic clutter. This entire room is a disaster, with desks turned over and shredded documents everywhere.

You can see a Closet here.

>take black key
Taken.

>w
Lobby
The front lobby where people would buy tickets into the Pizzeria. An arcade machine sits in the corner, fully operational, next to a wall-mounted television. Couches line the back wall facing the television and an empty pizza box. On top of the front desk is a cash register, a potted plant, and a Retro Computer that hasn't been used in years.

On the Front Desk is a Red Lockbox (closed).

You can also see a Pizzeria Door and an arcade machine here.

>w
You can't go that way.

>unlock red lockbox with black key
You unlock the Red Lockbox.

* * *

>e
Darkness
It is pitch dark, and you can't see a thing.

>n
Darkness
It is pitch dark, and you can't see a thing.

>e
Power Room
A red-lighted room with three walls of concrete and one giant steel door. Spooky. There's something on the wall here, a lever.

You can see a Steel Door here.

>pull lever
At first, nothing happens. After another moment, the arcade shakes and the power surges on. Light is restored to the entire facility, at least enough to see. Now, you need to get into the Pizzeria.

>pull lever
Good job!

* * *

>pull lever
At first, nothing happens. After another moment, the arcade shakes and the power surges on. Light is restored to the entire facility, at least enough to see. Now, you need to get into the Pizzeria.

>w
Storage Room
It's super dusty, and shelves line the walls. There's cleaning supplies, buckets, a mop, and bunches of paper.

You can see a Closet here.

>s
Game Library

>w
Private Study

>n
Office
You can see Closet here.

>w
Lobby
You can see a Pizzeria Door and an arcade machine here.

>s
(first opening the Pizzeria Door)
It seems to be locked.

>unlock Pizzeria Door
What do you want to unlock the Pizzeria Door with?

>key
You unlock the Pizzeria Door.

I beg your pardon?

>s
(first opening the Pizzeria Door)

Pizzeria
You can see a Pizzeria Door here.

>w
You can't go that way.

>e
You can't go that way.

>w
You can't go that way.

>s
You can't go that way.

>n
Lobby
You can see a Pizzeria Door and an arcade machine here.

>s
Pizzeria
You can see a Pizzeria Door here.

>w
You can't go that way.

* * *

>w
Storage Room
It's super dusty, and shelves line the walls. There's cleaning supplies, buckets, a mop, and bunches of paper.

You can see a Closet here.

>x closet
How about that. A shortcut. No clothes though, what a wasted opportunity for saving space.

* * *

>e
Power Room
A red-lighted room with three walls of concrete and one giant steel door. Spooky. There's something on the wall here, a lever.

You can see a Steel Door here.

>pull levr
You can't see any such thing.

>pull lever
Good job!

>w
Storage Room
You can see Closet here.

>s
Game Library

* * *

>s
(first opening the Pizzeria Door)
It seems to be locked.

>unlock
What do you want to unlock?

>key
What do you want to unlock the arcade front door key with?

>unlock door
What do you want to unlock the arcade front door key with?

>Pizzeria door
I didn't understand that sentence.

>unlock Pizzeria Door
What do you want to unlock the Pizzeria Door with?

* * *

>key
You unlock the Pizzeria Door.

>s
(first opening the Pizzeria Door)

Pizzeria
You can see a Pizzeria Door and a Banished One here.

>talk to Banished One
Do you have the coin?

>yes
Hand it over.

>give coin
You can't see any such thing.

* * *

>s
Darkness
It is pitch dark, and you can't see a thing.

>pull lever
Good job!

>activating lever
That's not a verb I recognise.

>pull lever
Good job!

* * *

>n
Office

>e
Storage Room

* * *

>w
Office

>w
Lobby
You can see a Pizzeria Door and an arcade machine here.

>play arcade machine with cheat codes
I only understood you as far as wanting to play the arcade machine.

>play with cheat codes
You win!

>take coin
You can't see any such thing.

>x arcade machine
You see nothing special about the arcade machine.

>opne arcade machine with cheat codes
That's not a verb I recognise.

>unlock with cheat codes
You win!

>unlock arcade machine
What do you want to unlock the arcade machine with?

* * *

>cheat codes
You unlock the arcade machine.

>take coin
You can't see any such thing.

>x coin
You can't see any such thing.

* * *

>w
Lobby
You can see a Pizzeria Door and an arcade machine here.

>play with cheat codes
You win!

>i
You are carrying:
  a coin
  a cheat codes
  a pager
  an arcade front door key

* * *

>w
Lobby
You can see a Pizzeria Door and an arcade machine here.

>unlock arcade machine
What do you want to unlock the arcade machine with?

* * *

>e
Storage Room

>w
Office

* * *

>w
Lobby
You can see a Pizzeria Door and an arcade machine (closed) here.

>save
Save failed.

>play something
You can't see any such thing.

>play arcade machine
You need to specify what to cut arcade machine with.

* * *

>e
Darkness
It is pitch dark, and you can't see a thing.

>s
Power Room
You can see a Steel Door here.

* * *

>w
Lobby
You can see a Pizzeria Door here.

>play arcade machine
What do you want to play the arcade machine with?

>play with nothing
You can't see any such thing.

>play with arcade key
You can't see any such thing.

* * *

>s
Power Room
You can see a Steel Door here.

>drop all
What do you want to drop those things in?

>drop key
Dropped.

* * *

>drop pager
Dropped.

>take all
There are none at all available!

>take pager and key
pager: Taken.
arcade front door key: Taken.

* * *

>w
Darkness
It is pitch dark, and you can't see a thing.

>w
You can't go that way.

>e
Darkness
It is pitch dark, and you can't see a thing.

>n
You can't go that way.

>s
Power Room

* * *

>i
You are carrying:
  a pager
  an arcade front door key

>put down pager
Dropped.

>i
You are carrying nothing.

>pick up pager
Taken.

* * *

>i
You are carrying:
  a pager
  an arcade front door key

>x key
You see nothing special about the arcade front door key.

>x aracde front door key
You can't see any such thing.

* * *

>i
You are carrying:
  a pager
  an arcade front door key

>x pager
It is pitch dark, and you can't see a thing.

>turn on light
You can't see any such thing.

>se
You can't go that way.

>south
(first opening the Pizzeria Door)
It seems to be locked.

>east
Darkness
It is pitch dark, and you can't see a thing.

>unlock door
What do you want to unlock the arcade front door key with?

>south
You can't see any such thing.

>south
Darkness
It is pitch dark, and you can't see a thing.

>east
Darkness
It is pitch dark, and you can't see a thing.

>east
Darkness
It is pitch dark, and you can't see a thing.

>east
You can't go that way.

>north
Power Room
A red-lighted room with three walls of concrete and one giant steel door. Spooky. There's something on the wall here, a lever.

You can see a Steel Door here.

>switch lever
It isn't something you can switch.

>x lever
A scratched chrome and iron lever, almost medieval. It is bolted onto the wall and in the up position.

>open steel door
It seems to be locked.

>south
Darkness
It is pitch dark, and you can't see a thing.

>west
Darkness
It is pitch dark, and you can't see a thing.

>east
Darkness
It is pitch dark, and you can't see a thing.

>west
Darkness
It is pitch dark, and you can't see a thing.

>north
Darkness
It is pitch dark, and you can't see a thing.

>south
Darkness
It is pitch dark, and you can't see a thing.

* * *

>east
Darkness
It is pitch dark, and you can't see a thing.

>north
Power Room
A red-lighted room with three walls of concrete and one giant steel door. Spooky. There's something on the wall here, a lever.

You can see a Steel Door here.

>turn lever
Nothing obvious happens.

>i
You are carrying:
  a pager
  an arcade front door key

I beg your pardon?

>switch lever on
It isn't something you can switch.

>i
You are carrying:
  a pager
  an arcade front door key

>x arcade front door key
You used it to get in to the arcade. You don't think it will have any further use, but you should keep it close just in case.

>s
Darkness
It is pitch dark, and you can't see a thing.

>w
Darkness
It is pitch dark, and you can't see a thing.

>w
Darkness
It is pitch dark, and you can't see a thing.

* * *

>w
You can't go that way.

>n
Darkness
It is pitch dark, and you can't see a thing.

>n
You can't go that way.

>e
(first opening the Closet)
It seems to be locked.

>e
(first opening the Closet)
It seems to be locked.

>s
Darkness
It is pitch dark, and you can't see a thing.

* * *

>e
You can't go that way.

>n
Power Room
A red-lighted room with three walls of concrete and one giant steel door. Spooky. There's something on the wall here, a lever.

You can see a Steel Door here.

>s
Darkness
It is pitch dark, and you can't see a thing.

* * *

>w
Darkness
It is pitch dark, and you can't see a thing.

>n
Darkness
It is pitch dark, and you can't see a thing.

* * *

>e
Power Room
A red-lighted room with three walls of concrete and one giant steel door. Spooky. There's something on the wall here, a lever.

You can see a Steel Door here.

>pull on lever
You can't see any such thing.

>pull lever
At first, nothing happens. After another moment, the arcade shakes and the power surges on. Light is restored to the entire facility, at least enough to see. Now, you need to get into the Pizzeria.

>s
Arcade Test Room
It is a room full of broken arcade machines. Nothing in here works, nothing in here is of use, but there is a chrome console that's blinking.

>x arcade machines
They're broken. End of that story, sadly.

>e
You can't go that way.

>w
Game Library
This place is full of shelves lined with game guides. The workers must've spent a lot of time in here during breaks, brushing up on their pop culture and videogame knowledge of easter eggs and secrets.

>x game guides
They're classics. One copy holds walkthroughs, another is a collection of gossips and rumors of secret rooms in games, the final guide about favorite videogame characters. That last one strikes you as the most interesting.

>e
Arcade Test Room
It is a room full of broken arcade machines. Nothing in here works, nothing in here is of use, but there is a chrome console that's blinking.

>w
Game Library
This place is full of shelves lined with game guides. The workers must've spent a lot of time in here during breaks, brushing up on their pop culture and videogame knowledge of easter eggs and secrets.

>n
Storage Room
It's super dusty, and shelves line the walls. There's cleaning supplies, buckets, a mop, and bunches of paper.

How about that. A shortcut. No clothes though, what a wasted opportunity for saving space.

>e
Power Room
A red-lighted room with three walls of concrete and one giant steel door. Spooky. There's something on the wall here, a lever.

You can see a Steel Door here.

>s
Arcade Test Room
It is a room full of broken arcade machines. Nothing in here works, nothing in here is of use, but there is a chrome console that's blinking.

>w
Game Library
This place is full of shelves lined with game guides. The workers must've spent a lot of time in here during breaks, brushing up on their pop culture and videogame knowledge of easter eggs and secrets.

* * *

>s
Arcade Test Room
It is a room full of broken arcade machines. Nothing in here works, nothing in here is of use, but there is a chrome console that's blinking.

>n
Power Room
A red-lighted room with three walls of concrete and one giant steel door. Spooky. There's something on the wall here, a lever.

You can see a Steel Door here.

>n
You can't go that way.

>s
Arcade Test Room
It is a room full of broken arcade machines. Nothing in here works, nothing in here is of use, but there is a chrome console that's blinking.

* * *

>w
Game Library
This place is full of shelves lined with game guides. The workers must've spent a lot of time in here during breaks, brushing up on their pop culture and videogame knowledge of easter eggs and secrets.

>s
You can't go that way.

>e
Arcade Test Room
It is a room full of broken arcade machines. Nothing in here works, nothing in here is of use, but there is a chrome console that's blinking.

>n
Power Room
A red-lighted room with three walls of concrete and one giant steel door. Spooky. There's something on the wall here, a lever.

You can see a Steel Door here.

>s
Arcade Test Room
It is a room full of broken arcade machines. Nothing in here works, nothing in here is of use, but there is a chrome console that's blinking.

* * *

>w
Game Library
This place is full of shelves lined with game guides. The workers must've spent a lot of time in here during breaks, brushing up on their pop culture and videogame knowledge of easter eggs and secrets.

>e
Arcade Test Room
It is a room full of broken arcade machines. Nothing in here works, nothing in here is of use, but there is a chrome console that's blinking.

>e
You can't go that way.

>s
You can't go that way.

>w
Game Library
This place is full of shelves lined with game guides. The workers must've spent a lot of time in here during breaks, brushing up on their pop culture and videogame knowledge of easter eggs and secrets.

* * *

>n
Storage Room
It's super dusty, and shelves line the walls. There's cleaning supplies, buckets, a mop, and bunches of paper.

How about that. A shortcut. No clothes though, what a wasted opportunity for saving space.

>east
Power Room
A red-lighted room with three walls of concrete and one giant steel door. Spooky. There's something on the wall here, a lever.

You can see a Steel Door here.

>w
Storage Room
It's super dusty, and shelves line the walls. There's cleaning supplies, buckets, a mop, and bunches of paper.

How about that. A shortcut. No clothes though, what a wasted opportunity for saving space.

>i
You are carrying:
  a pager
  an arcade front door key

>x pager
The thing that brought you to this wretched arcade. It's gone offline since you entered.

>w
(first opening the Closet)
It seems to be locked.

>e
Power Room
A red-lighted room with three walls of concrete and one giant steel door. Spooky. There's something on the wall here, a lever.

You can see a Steel Door here.

>unlock steel door with arcade front door key
That doesn't seem to fit the lock.

>i
You are carrying:
  a pager
  an arcade front door key

>pull lever
At first, nothing happens. After another moment, the arcade shakes and the power surges on. Light is restored to the entire facility, at least enough to see. Now, you need to get into the Pizzeria.

* * *

>s
Arcade Test Room
It is a room full of broken arcade machines. Nothing in here works, nothing in here is of use, but there is a chrome console that's blinking.

>s
You can't go that way.

>e
You can't go that way.

>x console
This is...this is a computer of some sort. Yes, it used to be part of one of the oldest of old computers that would take up entire rooms. There's a bunch of black flashdrives plugged into the side of the machine. Just in case, you bet, if any of the employees lost one.

>x flashdrive
A solid black flashdrive, one of many. It is completely conspicuous and could hold anything.

>take flashdrive
Taken.

>x flashdrive
A solid black flashdrive, one of many. It is completely conspicuous and could hold anything.

>x computers
You can't see any such thing.

>x computer
You can't see any such thing.

>x machine
You can't see any such thing.

>e
You can't go that way.

* * *

>n
Power Room
A red-lighted room with three walls of concrete and one giant steel door. Spooky. There's something on the wall here, a lever.

You can see a Steel Door here.

>x wall
You can't see any such thing.

>w
Storage Room
It's super dusty, and shelves line the walls. There's cleaning supplies, buckets, a mop, and bunches of paper.

How about that. A shortcut. No clothes though, what a wasted opportunity for saving space.

>x buckets
Buckets.

>x mop
A dirty mop.

>x paper
Scraps of paper that have orders for pizza, requests on machines that need fixing, notes between coworkers, acts of dislike for the boss of the arcade. Some pieces of paper have organized lines of movements and button pressing. They are labeled as "cheat codes".

>x cleaning supplies
Bleach, toilet cleaner, deodorant, baking soda. Basic things.

>x shortcut
You can't see any such thing.

>n
You can't go that way.

>i
You are carrying:
  a black flashdrive
  a pager
  an arcade front door key

>e
Power Room
A red-lighted room with three walls of concrete and one giant steel door. Spooky. There's something on the wall here, a lever.

You can see a Steel Door here.

>w
Storage Room
It's super dusty, and shelves line the walls. There's cleaning supplies, buckets, a mop, and bunches of paper.

How about that. A shortcut. No clothes though, what a wasted opportunity for saving space.

>e
Power Room
A red-lighted room with three walls of concrete and one giant steel door. Spooky. There's something on the wall here, a lever.

You can see a Steel Door here.

* * *

>s
Arcade Test Room
It is a room full of broken arcade machines. Nothing in here works, nothing in here is of use, but there is a chrome console that's blinking.

>x console
This is...this is a computer of some sort. Yes, it used to be part of one of the oldest of old computers that would take up entire rooms. There's a bunch of black flashdrives plugged into the side of the machine. Just in case, you bet, if any of the employees lost one.

>use
That's not a verb I recognise.

>w
Game Library
This place is full of shelves lined with game guides. The workers must've spent a lot of time in here during breaks, brushing up on their pop culture and videogame knowledge of easter eggs and secrets.

>x guides
They're classics. One copy holds walkthroughs, another is a collection of gossips and rumors of secret rooms in games, the final guide about favorite videogame characters. That last one strikes you as the most interesting.

>look behind shelves
You can't see any such thing.

>e
Arcade Test Room
It is a room full of broken arcade machines. Nothing in here works, nothing in here is of use, but there is a chrome console that's blinking.

>look behind console
You can't see any such thing.

>x machines
They're broken. End of that story, sadly.

>e
You can't go that way.

* * *

>w
Game Library
This place is full of shelves lined with game guides. The workers must've spent a lot of time in here during breaks, brushing up on their pop culture and videogame knowledge of easter eggs and secrets.

>en
That's not a verb I recognise.

>n
Storage Room
It's super dusty, and shelves line the walls. There's cleaning supplies, buckets, a mop, and bunches of paper.

How about that. A shortcut. No clothes though, what a wasted opportunity for saving space.

* * *

>w
Game Library
This place is full of shelves lined with game guides. The workers must've spent a lot of time in here during breaks, brushing up on their pop culture and videogame knowledge of easter eggs and secrets.

>w
Private Study
This is where the body was found. The scene of the crime. Now it is a clean office, with a clean desk and a clean bookcase.

>we
That's not a verb I recognise.

>e
Game Library
This place is full of shelves lined with game guides. The workers must've spent a lot of time in here during breaks, brushing up on their pop culture and videogame knowledge of easter eggs and secrets.

>w
Private Study
This is where the body was found. The scene of the crime. Now it is a clean office, with a clean desk and a clean bookcase.

>e
Game Library
This place is full of shelves lined with game guides. The workers must've spent a lot of time in here during breaks, brushing up on their pop culture and videogame knowledge of easter eggs and secrets.

* * *

>w
Private Study
This is where the body was found. The scene of the crime. Now it is a clean office, with a clean desk and a clean bookcase.

>n
Office
Multiple people must've worked in here. No one person could have made this apocalyptic clutter. This entire room is a disaster, with desks turned over and shredded documents everywhere.

How about that. A shortcut. No clothes though, what a wasted opportunity for saving space.

>s
Private Study
This is where the body was found. The scene of the crime. Now it is a clean office, with a clean desk and a clean bookcase.

>x body
You can't see any such thing.

>x desk
A clean desk with a stack of manilla folders. The wood furnishing is impeccable and spotless.

>take folders
That's fixed in place.

>x bookcase
A boring but clean bookcase. Full of books, boring books, read by a most likely boring man, on a boring day of work. How boring.

>n
Office
Multiple people must've worked in here. No one person could have made this apocalyptic clutter. This entire room is a disaster, with desks turned over and shredded documents everywhere.

How about that. A shortcut. No clothes though, what a wasted opportunity for saving space.

>e
(first opening the Closet)
It seems to be locked.

>w
Lobby
The front lobby where people would buy tickets into the Pizzeria. An arcade machine sits in the corner, fully operational, next to a wall-mounted television. Couches line the back wall facing the television and an empty pizza box. On top of the front desk is a cash register, a potted plant, and a Retro Computer that hasn't been used in years.

On the Front Desk is a Red Lockbox.

You can also see a Pizzeria Door and an arcade machine here.

>open pizzeria door
It seems to be locked.

>x red lockbox
A small red lockbox. It appears almost just like one of those extravagant wedding ring boxes. Maybe it used to be one. Now it serves a different purpose.

>x arcade machine
An acient piece of technology. It still works, but you've never played one of these before. It's a fighting game. A piece of taped paper onto the side of the arcade machine.

>x paper
It reads, "If you win, so does he!"

>x cash register
It's empty. Damn.

>x computer
God, you haven't used one of these since the late 90s. How bulky and slow this computing device must've been. A couple documents are open and on the interface: "Regarding the steel door", "Stop gossiping in the storage room", "Project Glitch". Unfortunately for you, these documents are locked.

>x documents
You can't see any such thing.

>i
You are carrying:
  a black flashdrive
  a pager
  an arcade front door key

>x flashdrive
A solid black flashdrive, one of many. It is completely conspicuous and could hold anything.

>take key
(the arcade front door key)
You already have that.

>take all
There are none at all available!

>e
Office
Multiple people must've worked in here. No one person could have made this apocalyptic clutter. This entire room is a disaster, with desks turned over and shredded documents everywhere.

How about that. A shortcut. No clothes though, what a wasted opportunity for saving space.

>take key
(the arcade front door key)
You already have that.

>take steel door key
You can't see any such thing.

>look
Office
Multiple people must've worked in here. No one person could have made this apocalyptic clutter. This entire room is a disaster, with desks turned over and shredded documents everywhere.

How about that. A shortcut. No clothes though, what a wasted opportunity for saving space.

>x desk
You can't see any such thing.

>x documents
No story here. Just this wreck. You don't have the time to reattach all of the shreds to confirm anything. Upon closer inspection, there is a black key under all this paper.

>take black key
Taken.

>e
(first opening the Closet)
It seems to be locked.

>s
Private Study
This is where the body was found. The scene of the crime. Now it is a clean office, with a clean desk and a clean bookcase.

>n
Office
Multiple people must've worked in here. No one person could have made this apocalyptic clutter. This entire room is a disaster, with desks turned over and shredded documents everywhere.

How about that. A shortcut. No clothes though, what a wasted opportunity for saving space.

* * *

>s
Private Study
This is where the body was found. The scene of the crime. Now it is a clean office, with a clean desk and a clean bookcase.

>x desk
A clean desk with a stack of manilla folders. The wood furnishing is impeccable and spotless.

>x manilla folders
You can't see any such thing.

>open desk
It isn't something you can open.

>w
You can't go that way.

>n
Office
Multiple people must've worked in here. No one person could have made this apocalyptic clutter. This entire room is a disaster, with desks turned over and shredded documents everywhere.

How about that. A shortcut. No clothes though, what a wasted opportunity for saving space.

>w
Lobby
The front lobby where people would buy tickets into the Pizzeria. An arcade machine sits in the corner, fully operational, next to a wall-mounted television. Couches line the back wall facing the television and an empty pizza box. On top of the front desk is a cash register, a potted plant, and a Retro Computer that hasn't been used in years.

On the Front Desk is a Red Lockbox.

You can also see a Pizzeria Door and an arcade machine here.

>open pizzeria door with black key
That doesn't seem to fit the lock.

>x couches
Some soft couches. Now is not the time for relaxing, however.

>look behind couches
You can't see any such thing.

>x tv
You can't see any such thing.

>x television
A television that hangs on one of the walls. It is off and unoperational.

I beg your pardon?

* * *

I beg your pardon?

>s
Private Study
This is where the body was found. The scene of the crime. Now it is a clean office, with a clean desk and a clean bookcase.

>e
Game Library
This place is full of shelves lined with game guides. The workers must've spent a lot of time in here during breaks, brushing up on their pop culture and videogame knowledge of easter eggs and secrets.

>take guide
Taken.

>x guide
This copy has one page bookmarked. The article reads, "Careful who you talk to! Certain NPCs are not just questgivers. Given the chance, they can turn on you, and they'll beocme a threat!

>n
Storage Room
It's super dusty, and shelves line the walls. There's cleaning supplies, buckets, a mop, and bunches of paper.

How about that. A shortcut. No clothes though, what a wasted opportunity for saving space.

>take bunches of paper
You can't see any such thing.

>take paper
That's fixed in place.

>x paper
Scraps of paper that have orders for pizza, requests on machines that need fixing, notes between coworkers, acts of dislike for the boss of the arcade. Some pieces of paper have organized lines of movements and button pressing. They are labeled as "cheat codes".

>e
Power Room
A red-lighted room with three walls of concrete and one giant steel door. Spooky. There's something on the wall here, a lever.

You can see a Steel Door here.

>x steel door
Steel, heavy metal, for restricting access and locking away something for good. Why? What's in this arcade?

>s
Arcade Test Room
It is a room full of broken arcade machines. Nothing in here works, nothing in here is of use, but there is a chrome console that's blinking.

* * *

>n
Storage Room
It's super dusty, and shelves line the walls. There's cleaning supplies, buckets, a mop, and bunches of paper.

How about that. A shortcut. No clothes though, what a wasted opportunity for saving space.

>w
(first opening the Closet)
It seems to be locked.

>open closet
It seems to be locked.

>unlock closet with black key
That doesn't seem to fit the lock.

>w
(first opening the Closet)
It seems to be locked.

>s
Game Library
This place is full of shelves lined with game guides. The workers must've spent a lot of time in here during breaks, brushing up on their pop culture and videogame knowledge of easter eggs and secrets.

* * *

>w
Private Study
This is where the body was found. The scene of the crime. Now it is a clean office, with a clean desk and a clean bookcase.

* * *

>s
Private Study
This is where the body was found. The scene of the crime. Now it is a clean office, with a clean desk and a clean bookcase.

>w
You can't go that way.

* * *

>e
(first opening the Closet)
It seems to be locked.

>unlock closet with arcade front door key
You unlock the Closet.

* * *

I beg your pardon?

>e
Power Room
A red-lighted room with three walls of concrete and one giant steel door. Spooky. There's something on the wall here, a lever.

You can see a Steel Door here.

>x front door key
You used it to get in to the arcade. You don't think it will have any further use, but you should keep it close just in case.

>w'
That's not a verb I recognise.

>w
Storage Room
It's super dusty, and shelves line the walls. There's cleaning supplies, buckets, a mop, and bunches of paper.

How about that. A shortcut. No clothes though, what a wasted opportunity for saving space.

>i
You are carrying:
  a final guide
  a black key
  a black flashdrive
  a pager
  an arcade front door key

>x black key
A black key, it is small. Therefore, it would probably unlock something small.

>x flashdrive
A solid black flashdrive, one of many. It is completely conspicuous and could hold anything.

>x pager
The thing that brought you to this wretched arcade. It's gone offline since you entered.

>s
Game Library
This place is full of shelves lined with game guides. The workers must've spent a lot of time in here during breaks, brushing up on their pop culture and videogame knowledge of easter eggs and secrets.

>x guides
They're classics. One copy holds walkthroughs, another is a collection of gossips and rumors of secret rooms in games, the final guide about favorite videogame characters. That last one strikes you as the most interesting.

* * *

I beg your pardon?

>e
Arcade Test Room
It is a room full of broken arcade machines. Nothing in here works, nothing in here is of use, but there is a chrome console that's blinking.

>x machines
They're broken. End of that story, sadly.

>x me
As good-looking as ever.

* * *

>pull
What do you want to pull?

>lever
You can't see any such thing.

>pull lever
You can't see any such thing.

I beg your pardon?

* * *

>turn on light
You can't see any such thing.

>w
You can't go that way.

* * *

>e
Darkness
It is pitch dark, and you can't see a thing.

>e
(first opening Closet)
It seems to be locked.

>w
Darkness
It is pitch dark, and you can't see a thing.

>a
That's not a verb I recognise.

>n
You can't go that way.

>s
(first opening the Pizzeria Door)
It seems to be locked.

>e
Darkness
It is pitch dark, and you can't see a thing.

* * *

>e
(first opening Closet)
It seems to be locked.

>n
You can't go that way.

>s
Darkness
It is pitch dark, and you can't see a thing.

>s
You can't go that way.

>e
Darkness
It is pitch dark, and you can't see a thing.

>s
You can't go that way.

>n
Power Room
There's something on the wall here, a lever.

You can see a Steel Door here.

>pull lever
Good job!

>open steel door
It seems to be locked.

>x lever
The same old lever. Now it is in the down position.

>s
Arcade Test Room
It is a room full of broken arcade machines.

>x arcade machine
I only understood you as far as wanting to examine the arcade front door key.

>x machines
You can't see any such thing.

>x arcade machines
I only understood you as far as wanting to examine the arcade front door key.

>x broken arcade machines
You can't see any such thing.

>e
You can't go that way.

>w
Game Library

>e
Arcade Test Room
It is a room full of broken arcade machines.

>w
Game Library

>w
Private Study
This is where the body was found. The scene of the crime.

>e
Game Library

>e
Arcade Test Room
It is a room full of broken arcade machines.

>n
Power Room
There's something on the wall here, a lever.

You can see a Steel Door here.

>e
(first opening the Steel Door)
It seems to be locked.

>w
Storage Room
It's super dusty, and shelves line the walls.

You can see Closet here.

>w
(first opening Closet)
It seems to be locked.

>e
Power Room
There's something on the wall here, a lever.

You can see a Steel Door here.

>w
Storage Room
It's super dusty, and shelves line the walls.

You can see Closet here.

>n
You can't go that way.

>s
Game Library

>e
Arcade Test Room
It is a room full of broken arcade machines.

* * *

>n
Power Room
There's something on the wall here, a lever.

You can see a Steel Door here.

>s
Arcade Test Room
It is a room full of broken arcade machines.

>w
Game Library

* * *

>w
Private Study
This is where the body was found. The scene of the crime.

>n
Office
Multiple people must've worked in here.

You can see Closet here.

>w
Lobby
The front lobby where people would buy tickets into the Pizzeria. An arcade machine sits in the corner, fully operational.

You can see a Pizzeria Door and an arcade machine here.

>x arcade machine
An acient piece of technology. It still works, but you've never played one of these before.

>play arcade machine
You lose instantly. If only you had something to help...

>open pizzeria door
It seems to be locked.

>e
Office
Multiple people must've worked in here.

You can see Closet here.

>s
Private Study
This is where the body was found. The scene of the crime.

>w
You can't go that way.

>e
Game Library

* * *

>e
Arcade Test Room
It is a room full of broken arcade machines.

>s
You can't go that way.

* * *

>n
Power Room
There's something on the wall here, a lever.

You can see a Steel Door here.

>w
Storage Room
It's super dusty, and shelves line the walls.

You can see Closet here.

>x shelves
There's something on here, a piece of paper.

On the shelves is a cheat codes.

>x paper
You can't see any such thing.

>x piece of paper
You can't see any such thing.

>take piece paper
You can't see any such thing.

>x cheat codes
Universal cheat codes, from the developer themself. They could be applied to any machine here.

>take cheat codes
Taken.

>e
Power Room
There's something on the wall here, a lever.

You can see a Steel Door here.

>s
Arcade Test Room
It is a room full of broken arcade machines.

>e
You can't go that way.

* * *

>w
Game Library

>n
Storage Room
It's super dusty, and shelves line the walls.

You can see Closet here.

>s
Game Library

>w
Private Study
This is where the body was found. The scene of the crime.

* * *

>n
Office
Multiple people must've worked in here.

You can see Closet here.

>n
You can't go that way.

>w
Lobby
The front lobby where people would buy tickets into the Pizzeria. An arcade machine sits in the corner, fully operational.

You can see a Pizzeria Door and an arcade machine here.

* * *

>play arcade machine
You lose instantly. If only you had something to help...

>use cheat codes
That's not a verb I recognise.

>cheat
That's not a verb I recognise.

>play with cheat codes
You win! Youve earned one player token coin!

>open pizzeria door
It seems to be locked.

>i
You are carrying:
  a coin
  a cheat codes
  a pager
  an arcade front door key

>use key
That's not a verb I recognise.

>unlock
What do you want to unlock?

>pizzeria door
What do you want to unlock the Pizzeria Door with?

>key
You unlock the Pizzeria Door.

>open door
(the arcade front door key)
It isn't something you can open.

>open pizzeria door
You open the Pizzeria Door.

>go through pizzeria door
Pizzeria
This used to be the center for all gamers. It had everything: the arcade itself, pop music bursting over stereo speakers, pizza, prize exchange booths at every corner, more pizza. At this moment, all of that lies in darkness. There's someone here.

You can see a Pizzeria Door and a Banished One here.

>talk to banished one
I need a chance...just one more go...need the golden opportunity...

>give key
Please answer yes or no.

>yes
Hand it over.

>give golden coin
You can't see any such thing.

>i
You are carrying:
  a coin
  a cheat codes
  a pager
  an arcade front door key

>give coin
(to the Banished One)

    *** As you pass on the shiny gold coin to The Banished One, everything flashes, and darkness consumes the whole room. Out of the emptiness, a voice speaks. "I am free, at last." ***

Would you like to RESTART, RESTORE a saved game, QUIT or UNDO the last command?

* * *

>w
You can't go that way.

* * *

>s
Power Room

>activate lever
That's not a verb I recognise.

* * *

>e
(first opening Closet)
It seems to be locked.

>s
Darkness
It is pitch dark, and you can't see a thing.

>drop pager
Dropped.

>drop key
Dropped.

>ake all
That's not a verb I recognise.

>take all
There are none at all available!

>take key
Taken.

>take all
There are none at all available!

>drop key
Dropped.

>take all
There are none at all available!

* * *

>n
Darkness
It is pitch dark, and you can't see a thing.

>e
Power Room
You can see a Steel Door here.

>pull lever
Good job!

* * *

>w
Storage Room
You can see Closet here.

>s
Dormitory

>w
Private Study

* * *

>n
Office
You can see Closet here.

>e
(first opening Closet)
It seems to be locked.

>w
Lobby
You can see a Pizzeria Door and an arcade machine here.

* * *

>w
Lobby
You can see a Pizzeria Door here.

>e
Office

* * *

>s
Darkness
It is pitch dark, and you can't see a thing.

>activate
What do you want to activate?

>lever
Good job!

>n
Office

* * *

>w
Office

>e
Storage Room

* * *

>n
Office

* * *

>e
You can't go that way.

>w
Lobby
You can see a Pizzeria Door here.

* * *

>play arcade machine
You lose instantly.

>play with cheatcodes
You can't see any such thing.

* * *

>n
Darkness
It is pitch dark, and you can't see a thing.

>e
Power Room
There's something on the wall here, a lever.

You can see a Steel Door here.

>pull lever
Good job!

>pull lever
Good job!

>x lever
The same old lever. Now it is in the down position.

>pull lever
Good job!

* * *

>s
Darkness
It is pitch dark, and you can't see a thing.

>n
Darkness
It is pitch dark, and you can't see a thing.

>restart
Are you sure you want to restart?

Please answer yes or no.

>yes
The lock clicks, and the glass door painfully wretches open. This is the place. The abadoned arcade at the edge of Downtown. The musty tomb of the lost and damned technological behemoths and radical trends of 80s and 90s pop culture.  The scene of the crime, where the owner was brtually, and supposedly, murdered. At least, that's what the headlines bolded out in capital lettering that Friday morning. Little did you know you'd end up chasing a lead to disprove that claim, twenty years later. This could be it. The story of the decade. Suddenly, the pager at your side beeps restlessly. You've had it for almost two weeks now, and it's never gone off this frequently. The messages ping in a chaotic stream saying just one thing over and over... GETMEOUTOFHEREGETMEOUTOFHEREGETMEOUTOFHERE
Control Freak
An Interactive Fiction by Galen Nakama
Release 1 / Serial number 170223 / Inform 7 build 6M62 (I6/v6.33 lib 6/12N) SD

Darkness
It is pitch dark, and you can't see a thing.

>s
(first opening the Pizzeria Door)
It seems to be locked.

* * *

>unlock
What do you want to unlock?

>unlock Pizzeria Door
You can't see any such thing.

>w
You can't go that way.

* * *

>e
Power Room
There's something on the wall here, a lever.

You can see a Steel Door here.

>x lever
A scratched chrome and iron lever, almost medieval. It is bolted onto the wall and in the up position.

>pull down lever
I only understood you as far as wanting to pull down.

>pull lever
Good job!

>x lever
The same old lever. Now it is in the down position

>pull lever
Good job!

* * *

>x lever
The same old lever. Now it is in the down position

>w
Storage Room
It's super dusty, and shelves line the walls.

You can see Closet here.

* * *

>play with cheat codes
You can't see any such thing.

>play arcade machine with cheat codes
I only understood you as far as wanting to play the arcade machine.

>play arcade machine
You lose instantly.

>unlock
What do you want to unlock with?

>cheat codes
You win!

* * *

>w
You can't go that way.

>s
(first opening the Pizzeria Door)
It seems to be locked.

* * *

>w
Lobby
You can see a Pizzeria Door here.

>play arcade machine
You lose instantly

>e
Office

* * *

>play arcade machine
You lose instantly

* * *

>activate lever
Good job!

>pull lever
It is fixed in place.

* * *

>e
Darkness
It is pitch dark, and you can't see a thing.

>n
Power Room
There's something on the wall here, a lever.

You can see a Steel Door here.

* * *

>pull lever
Good job!

>s
Arcade Test Room
It is a room full of broken arcade machines.

* * *

>n
Storage Room
It's super dusty, and shelves line the walls.

You can see Closet here.

>x shelves
There's something on here, a piece of paper labeled "cheat codes".

On the shelves is a cheat codes.

>take cheat codes
Taken.

>s
Game Library

* * *

>n
Office
Multiple people must've worked in here.

You can see Closet here.

>w
Lobby
The front lobby where people would buy tickets into the Pizzeria.

An acient piece of technology. It still works, but you've never played one of these before.

You can also see a Pizzeria Door here.

>play arcade machine with cheat codes
I only understood you as far as wanting to play the arcade machine.

* * *

>i
You are carrying:
  a coin
  a cheat codes
  a pager
  an arcade front door key

>s
(first opening the Pizzeria Door)
It seems to be locked.

>unlock Pizzeria Door with key
You unlock the Pizzeria Door.

>s
(first opening the Pizzeria Door)

Pizzeria
You can see a Pizzeria Door and a Banished One here.

* * *

>yes
Hand it over.

>give coin
(to the Banished One)

    *** You win ***

Would you like to RESTART, RESTORE a saved game, QUIT or UNDO the last command?

* * *

>s
(first opening the Pizzeria Door)
It seems to be locked.

>n
Darkness
It is pitch dark, and you can't see a thing.

>e
Darkness
It is pitch dark, and you can't see a thing.

* * *

>s
Power Room

>x lever
You see nothing special about the red lever.

>activate lever
That's not a verb I recognise.

>pull lever
It is fixed in place.

>activate
That's not a verb I recognise.

* * *

>pull
What do you want to pull?

* * *

>x front desk
You see nothing special about Front desk.

* * *

>x key
It has no further use.

* * *

>x me
It is pitch dark, and you can't see a thing.

>e
Darkness
It is pitch dark, and you can't see a thing.

* * *

>n
Darkness
It is pitch dark, and you can't see a thing.

>e
Power Room
A red-lighted room with three walls of concrete and one intimidating steel door. Spooky. There's something on the wall here, a lever. Next to that lever is a metal sign.

You can see a Steel Door here.

>x me
A young and handsome reporter. That's who you used to be. Now you're a young and disheveled reporter. Do what you do best: get that story.